5

10

S---------
-D-D-D----
--------DJ
D-D---D---
----------